type octile
height 37
width 37
map
@@@@@@@@@@@@@@@@@@@@@@@@@@@@@@@@@@@@@
@@@@@@@@@@@@@@@@@@@@@@@@@@@@@@@@@@@@@
@@@TTTTTT@@@@@@@@@@TTT@@@@@@@@@@@@@@@
@@T......T@TTTTTT@T...T@@@@@@@@@@@@@@
@@T......TT......TT...T@@@@@@@@@@@@@@
@@T...................T@@@@@@@@@@@@@@
@@T...................T@@@@@@@@@@@@@@
@@T...................T@@@@@@@@@@@@@@
@@T....S..............T@@@@@@@@@@@@@@
@@@TT.................T@@@@@@@@@@@@@@
@@@TT.................T@@@@@@@@@@@@@@
@@T..................T@@@@@@@@@@@@@@@
@@T...................T@@@@@@@@@@@@@@
@@....................T@@@@@@@@@@@@@@
@@..........TTT.......T@@@@@@@@@@@@@@
@@T.........T@T.......T@@@@@@@@@@@@@@
@@T.........T@T.......T@@@@@@@@@@@@@@
@@@TT.......T@T.......T@@@@@@@@@@@@@@
@@@@T.......T@T.......T@@@@@@@@@@@@@@
@@@T........T@T.......T@@@@@@@@@@@@@@
@@@T........T@T.......T@@@@@@@@@@@@@@
@@@T........TTTG......T@@@@@@@@@@@@@@
@@@T..................T@@@@@@@@@@@@@@
@@@T..................T@@@@@@@@@@@@@@
@@@T..................T@@@@@@@@@@@@@@
@@@@T.................T@@@@@@@@@@@@@@
@@@TT.................T@@@@@@@@@@@@@@
@@T...................T@@@@@@@@@@@@@@
@@T...................T@@@@@@@@@@@@@@
@@T...................T@@@@@@@@@@@@@@
@@@TT.................T@@@@@@@@@@@@@@
@@@@@TTT..............T@@@@@@@@@@@@@@
@@@@@@@T.TTTTTTTTTTTTT@@@@@@@@@@@@@@@
@@@@@@@@T@@@@@@@@@@@@@@@@@@@@@@@@@@@@
@@@@@@@@@@@@@@@@@@@@@@@@@@@@@@@@@@@@@
@@@@@@@@@@@@@@@@@@@@@@@@@@@@@@@@@@@@@
@@@@@@@@@@@@@@@@@@@@@@@@@@@@@@@@@@@@@
