type octile
height 92
width 109
map
@@@@@@@@@@@@@@@@@@@@@@@@@@@@@@@@@@@@@@@@@@@@@@@@@@@@@@@@@@@@@@@@@@@@@@@@@@@@@@@@@@@@@@@@@@@@@@@@@@@@@@@@@@@@@
@@@@@@@@@@@@@@@@@@@@@@@@@@@@@@@@@@@@@@@@@@@@@@@@@@@@@@@@@@@@@@@@@@@@@@@@@@@@@@@@@@@@@@@@@@@@@@@@@@@@@@@@@@@@@
@@@@@@@@@@@@@@@@@@@@@@@@@@@@@@@@@@@@@@@@@@@@@@@@@@@@@@@@@@@@@@@@@@@@@@@@@@@@@@@@@@@@@@@@@@@@@@@@@@@@@@@@@@@@@
@@@@@@@@@@@@@@@@@@@@@@@@@@@@@@@@@@@@@@@@@@@@@@@@@@@@@TTTTTTTTTTTTTTTTTTTTTTTTTTTTTTTTTTTTTTTTTTTT@@@@@@@@@@@@
@@@@@@@@@@@@@@@@@@@@@@@@@@@@@@@@@@@@@@@@@@@@@@@@@@@@T............................................T@@@@@@@@@@@
@@@@@@@@@@@@@@@@@@@@@@@@@@@@@@@@@@@@@@@@@@@@@@@@@@@@T............................................T@@@@@@@@@@@
@@@@@@@@@@@@@@@@@@@@@@@@@@@@@@@@@@@@@@@@@@@@@@@@@@@@T............................................T@@@@@@@@@@@
@@@@@@@@@@@@@@@@@@@@@@@@@@@@@@@@@@@@@@@@@@@@@@@@@@@@T............................................T@@@@@@@@@@@
@@@@@@@@@@@@@@@@@@@@@@@@@@@@@@@@@@@@@@@@@@@@@@@@@@@@T............................................T@@@@@@@@@@@
@@@@@@@@@@@@@@@@@@@@@@@@@@@@@@@@@@@@@@@@@@@@@@@@@@@@T....................................TTT.....T@@@@@@@@@@@
@@@@@@@@@@@@@@@@@@@@@@@@@@@@@@@@@@@@@@@@@@@@@@@@@@@@T....................................T@T.....T@@@@@@@@@@@
@@@@@@@@@@@@@@@@@@@@@@@@@@@@@@@@@@@@@@@@@@@@@@@@@@@@T............................TTTTTTTT@@T.....T@@@@@@@@@@@
@@@@@@@@@@@@@@@@@@@@@@@@@@@@@@@@@@@@@@@@@@@@@@@@@@@@T................................T@@@@@T......T@@@@@@@@@@
@@@@@@@@@@@@@@@@@@@@@@@@@@@@@@@@@@@@@@@@@@@@@@@@@@@@T................................T@@@@@T......T@@@@@@@@@@
@@@@@@@@@@@@@@@@@@@@@@@@@@@@@@@@@@@@@@@@@@@@@@@@@@@@T.............................TTT@@@@@@T......T@@@@@@@@@@
@@@@@@@@@@@@@@@@@@@@@@@@@@@@@@@@@@@@@@@@@@@@@@@@@@@@T.............................T@@@@@@@@T......T@@@@@@@@@@
@@@@@@@@@@@@@@@@@@@@@@@@@@@@@@@@@@@@@@@@@@@@@@@@@@@@@TTTTTTTT....TTTTTTTTTTTTTTTTT@@@@@@@@@@TTTTTT@@@@@@@@@@@
@@@@@@@@@@@@@@@@@@@@@@@@@@@@@@@@@@@@@@@@@@@@@@@@@@@@@@@@@@@@T....T@@@@@@@@@@@@@@@@@@@@@@@@@@@@@@@@@@@@@@@@@@@
@@@@@@@@@@@@@@@@@@@@@@@@@@@@@@@@@@@@@@@@@@@@@@@@@@@@@@@@@@@@T....T@@@@@@@@@@@@@@@@@@@@@@@@@@@@@@@@@@@@@@@@@@@
@@@@@@@@@@@@@@@@@@@@@@@@@@@@@TTTTTTTTTTT@@@@@@@@@@@@@@@TTTTTT....TTTTTTTTTTTTTTTT@@@@@@@@@@@@@@@@@@@@@@@@@@@@
@@@@@@@@@@@@@@@@@@@@@@@@@@@@T...........T@@@@@@@@@@@TTT..........................T@@@@@@@@@@@@@@@@@@@@@@@@@@@
@@@@@TTTTTTT@@@@TTTTTT@@@@@@T...........T@@@@@@@@@@T.............................T@@@@@@@@@@@@@@@@@@@@@@@@@@@
@@@@T.......T@@T......T@@@@@T...........T@@@@@@@@@@T.............................T@@@@@@@@@@@@@@@@@@@@@@@@@@@
@@@@T..T.....TTT......T@@@@@T...........TT@@@@@@@@@T.............................T@@@@@@@@@@@@@@@@@@@@@@@@@@@
@@@@T.................T@@@@@T.............T@@@@@@@@T.............................T@@@@@@@@@@@@@@@@@@@@@@@@@@@
@@@@T.................TTT@@@T.............T@@@@@@@@@TTTTTTTTTTTTTTTTTTTTTTTT.....T@@@@@@@@@@@@@@@@@@@@@@@@@@@
@@@@T....................T@@T.............TTTT@@@@@@@@@@@@@@@@@@@@@@@@@@@@@T.....T@@@@@@@@@@@@@@@@@@@@@@@@@@@
@@@@T....................TTTT.................TTTT@@@@@@@@@@@@@@@@@@@@@@@@@T.....TTTTTTTT@@@@TTTTTTTTTTTT@@@@
@@@@T.............................................@@@@@@@@@@@@@@@@@@@@@@@@@T.............T@@T............T@@@
@@@@@T............................................@@@@@@@@@@@@@@@@@@@@@@@@@T.............T@@T............T@@@
@@@@@T............................................@@@@@@@@@@@@@@@@@@@@@@@@@T.............T@@T............T@@@
@@@@@T............................................@T@@@@@@@@@@@@@@@@@@@@@@@T.............T@@T............T@@@
@@@@@@T..................TTTT.......................T@@@@@T@@@T@@@@@@@@@@@@T.....TTTT....T@@T............T@@@
@@@@@@@TTTT..............T@@T........................TTTTT.....T@@@@@@@@@@@T.....T@@T....T@@T............T@@@
@@@@@@@@@@T..............T@@T...................................@@@@@@@@@@@T.....T@@T....T@@T............T@@@
@@@@@@@@@@T..............T@@T.@T@@..............................T@@@@@@@@@@T.....TTTT....TTTT............T@@@
@@@@@@@@@@T..............T@@@T@@@@T...........S.................T@@@@@@@@@@T.............................T@@@
@@@@@@@@@@T..............T@@@@@@@@T.............................T@@@@@@@@@@T.............................T@@@
@@@@@@@@@@T..............T@@@@@@@@@T............................TT@@@@@@@@@T......................G......T@@@
@@@@@TTTTT...............T@@@@@@@@@T..............................T@@@@@@@@T.............................T@@@
@@@@T....................T@@@@@@@@@T...............................@@@@@@@@T.....TTTT....TTTT............T@@@
@@@@T....................T@@@@@@@@@T.................................@@@@@@T.....T@@T....T@@T............T@@@
@@@@T....................T@@@T@@@TT...................................@TT@@T.....T@@T....T@@@TT..........T@@@
@@@@T....................T@@T.TTT........................................TT@.....T@@T....T@@@@@@@........T@@@
@@@T.....................T@@T..............................................@.....T@T.....T@@@@@@T........T@@@
@@@T.....................T@@T..............................................@.....T@T.....T@@@@@@T........T@@@
@@@T.....................T@@T..............................................@.....T@T.....T@@@@@@T........T@@@
@@@T.....................T@@T..............................................@.....T@T.....T@@@@@@T........T@@@
@@@@T....................T@@@@TTTT.........................................@.....T@@.....T@@@@@@T........T@@@
@@@@T....................T@@@@@@@@T........................................@.....T@@.....T@@@@@@@........T@@@
@@@@T....................T@@@@@@@@@T.......................................@.....T@@.....T@@@@@T.........T@@@
@@@@T...................T@@@@@@@@@@T.......................................@.....T@@.....T@@@@T..........T@@@
@@@@@T.................T@@@@@@@@@@@T.......................................@.....T@T.....T@@@@T..........T@@@
@@@@@@TT..........T....T@@@@@@@@@@@T.......................................@.....T@T.....T@@@T...........T@@@
@@@@@@@T........TT@TTTT@@@@@@@@@@@T........................................@.....T@T.....T@@@T...........T@@@
@@@@@@@@T......T@@@@@@@@@@@@@@@@@T.........................................@.....T@T.....T@@@@T..........T@@@
@@@@@@@@@TTTTTT@@@@@@@@@@@@@@@@@@@TTTTTTTTT................................@.....T@T.....T@@@@T..........T@@@
@@@@@@@@@@@@@@@@@@@@@@@@@@@@@@@@@@@@@@@@@@@TT..............................@.....T@@.....T@@@T...........T@@@
@@@@@@@@@@@@@@@@@@@@@@@@@@@@@TTTTTTTTTTTTT@@T..............................T.....T@@.....T@@T............T@@@
@@@@@@@@@@@@@@@@@@@@@@@@@@@@T.............T@T....................................T@T.....T@@T............T@@@
@@@@@@@@@@@@@@@@@@@@@@@@@@@@T.............T@T....................................T@T.....T@@T............T@@@
@@@@@@@@@@@@@@@@@@@@@@@@@@@@T.............T@T....................................T@T.....T@@T............T@@@
@@@@@@@@@@@@@@@@@@@@@@@@@@@@T.............T@@TTTTT...TTTTT...TTTTT...TTTTT.......T@T.....T@@T............T@@@
@@@@@@@@@@@@@@@@@@@@@@@@@@@@T.............T@@@@@@T...T@@@T...T@@@T...T@@@T.......T@T.....T@@T............T@@@
@@@@@@@@@@@@@@@@@@@@@@@@@@@@T.............T@@@@@@@TTT@@@@@TTT@@@@@TTT@@@@@TTTTTTT@@T.....T@@T............T@@@
@@@@@@@@@@@@@@@@@@@@@@@@@@@@T.............T@@@@@@@@@@@@@@@@@@@@@@@@@@@@@@@@@@@@@@@@T.....T@@T............T@@@
@@@@@@@@@@@@@@@@@@@@@@@@@@@@@T............T@TTTTTTTTTTTTTTTTTTTTTTTTTTTTTTTTTTTTTT@T.....T@@T..........TT@@@@
@@@@@@@@@@@@@@@@@@@@@@@@@@@@@T............TT......................................TT.....T@@@TT......@@@@@@@@
@@@@@@@@@@@@@@@@@@@@@@@@@@@@@T...........................................................T@@@@T......@@@@@@@@
@@@@@@@@@@@@@@@@@@@@@@@@@@@@@T...........................................................T@@@@T......T@@@@@@@
@@@@@@@@@@@@@@@@@@@@@@@@@@@@@@T..........................................................T@@@@T......T@@@@@@@
@@@@@@@@@@@@@@@@@@@@@@@@@@@@@@T..........................................................T@@@@T......T@@@@@@@
@@@@@@@@@@@@@@@@@@@@@@@@@@@@@@@TTTTTT....TTTTTTTTTTTTTTTTTTTTTTTTTTTT....TTTTTTTTTTTTTTTT@@@@TT......@@@@@@@@
@@@@@@@@@@@@@@@@@@@@@@@@@@@@@@@@@@@@T....T@@@@@@@@@@@@@@@@@@@@@@@@@@T....T@@@@@@@@@@@@@@@@@@T........@T..T@@@
@@@@@@@@@@@@@@@@@@@@@@@@@@@@@@@@@@@@T....T@@@@@@@@@@@@@@@@@@@@@@@@@@T....T@@@@@@@@@@@@@@@@@@T............T@@@
@@@@@@@@@@@@@@@@@@@@@@@@@@@@@@@TTTTTT....T@@@@@TTTTTTTT@@@@@@@@@@@@@T....TTTTTTTTTTTTTTTTTTTT............T@@@
@@@@@@@@@@@@@@@@@@@@@@@@@@@@@@T...........T@@@T........T@@@@@@@@@@@T.....................................T@@@
@@@@@@@@@@@@@@@@@@@@@@@@@@@@@@T...........TTTTT........T@@@@@@@@@@@T.....................................T@@@
@@@@@@@@@@@@@@@@@@@@@@@@@@@@@T.........................T@@@@@@@@@@@T.....................................T@@@
@@@@@@@@@@@@@@@@@@@@@@@@@@@@@T.......................TT@@@@@@@@TT@@......................................T@@@
@@@@@@@@@@@@@@@@@@@@@@@@@@@@@T.......................T@@@@@@T............................................T@@@
@@@@@@@@@@@@@@@@@@@@@@@@@@@@@T.......................TT@@@@@T............................................T@@@
@@@@@@@@@@@@@@@@@@@@@@@@@@@@@T.........................T@@@@T............................................T@@@
@@@@@@@@@@@@@@@@@@@@@@@@@@@@@@T........................TT@@@T.......................TTT..................T@@@
@@@@@@@@@@@@@@@@@@@@@@@@@@@@@@T..........................T@@T......................@@@@T@@...............T@@@
@@@@@@@@@@@@@@@@@@@@@@@@@@@@@T...........................T@@T......................T@@@@@T...............T@@@
@@@@@@@@@@@@@@@@@@@@@@@@@@@@@T.........TTTT........TTTTTT@@@T.......................T@@@T................T@@@
@@@@@@@@@@@@@@@@@@@@@@@@@@@@@T........T@@@T........T@@@@@@@@T.......................T@@@T................T@@@
@@@@@@@@@@@@@@@@@@@@@@@@@@@@@@TTTTTTTT@@@@@TTTTTTTT@@@@@@@@@@TTTTTTTTTTTTTTTTTTTTTTT@@@@@TTTTTTTTTTTTTTTT@@@@
@@@@@@@@@@@@@@@@@@@@@@@@@@@@@@@@@@@@@@@@@@@@@@@@@@@@@@@@@@@@@@@@@@@@@@@@@@@@@@@@@@@@@@@@@@@@@@@@@@@@@@@@@@@@@
@@@@@@@@@@@@@@@@@@@@@@@@@@@@@@@@@@@@@@@@@@@@@@@@@@@@@@@@@@@@@@@@@@@@@@@@@@@@@@@@@@@@@@@@@@@@@@@@@@@@@@@@@@@@@
@@@@@@@@@@@@@@@@@@@@@@@@@@@@@@@@@@@@@@@@@@@@@@@@@@@@@@@@@@@@@@@@@@@@@@@@@@@@@@@@@@@@@@@@@@@@@@@@@@@@@@@@@@@@@
