octile type
height 15
width 15
map
S.#############
....#.........#
###.#.#####.###
#.....#.......#
#####.###.#####
#.#...#.......#
#.#.###.#####.#
#...#.......#.#
#.###.#######.#
#.#...#.#...#.#
#.#.#.#.###.###
#.#.#.#.#.#...#
#####.#.#.###.#
#..............
#############.G