octile type
height 11
width 11
map
S.#########
..#.......#
#.#.#.#####
#.#.#.....#
#.#.#####.#
#.#.#.#...#
#.#.#.###.#
#...#.....#
#.#####.###
#.#........
#########.G