type octile
height 22
width 22
map
S#.#.#.#.#.#.#.#.#.#.#
......................
#.#.#.#.#.#.#.#.#.#.#.
......................
.#.#.#.#.#.#.#.#.#.#.#
......................
#.#.#.#.#.#.#.#.#.#.#.
......................
.#.#.#.#.#.#.#.#.#.#.#
......................
#.#.#.#.#.#.#.#.#.#.#.
......................
.#.#.#.#.#.#.#.#.#.#.#
......................
#.#.#.#.#.#.#.#.#.#.#.
......................
.#.#.#.#.#.#.#.#.#.#.#
......................
#.#.#.#.#.#.#.#.#.#.#.
......................
#.#.#.#.#.#.#.#.#.#.#.
.....................G