octile type
height 24
width 24
map
S#.#.#.#.#.#.#.#.#.#.#.#
........................
#.#.#.#.#.#.#.#.#.#.#.#.
........................
.#.#.#.#.#.#.#.#.#.#.#.#
........................
#.#.#.#.#.#.#.#.#.#.#.#.
........................
.#.#.#.#.#.#.#.#.#.#.#.#
........................
#.#.#.#.#.#.#.#.#.#.#.#.
........................
.#.#.#.#.#.#.#.#.#.#.#.#
........................
#.#.#.#.#.#.#.#.#.#.#.#.
........................
.#.#.#.#.#.#.#.#.#.#.#.#
........................
#.#.#.#.#.#.#.#.#.#.#.#.
........................
.#.#.#.#.#.#.#.#.#.#.#.#
........................
#.#.#.#.#.#.#.#.#.#.#.#.
.......................G