octile type
height 23
width 23
map
S#.#.#.#.#.#.#.#.#.#.#.
.......................
#.#.#.#.#.#.#.#.#.#.#.#
.......................
.#.#.#.#.#.#.#.#.#.#.#.
.......................
#.#.#.#.#.#.#.#.#.#.#.#
.......................
.#.#.#.#.#.#.#.#.#.#.#.
.......................
#.#.#.#.#.#.#.#.#.#.#.#
.......................
.#.#.#.#.#.#.#.#.#.#.#.
.......................
#.#.#.#.#.#.#.#.#.#.#.#
.......................
.#.#.#.#.#.#.#.#.#.#.#.
.......................
#.#.#.#.#.#.#.#.#.#.#.#
.......................
.#.#.#.#.#.#.#.#.#.#.#.
.......................
#.#.#.#.#.#.#.#.#.#.#G#