type octile
height 70
width 144
map
...............................................................................................................................................#
...............................................................................................................................................#
...............................................................................................................................................#
...............................................................................................................................................#
.............................................................................................................................################  #
.............................................................................................................................################  #
.............###########################....................................................................................#######............#
.............###########################....................................................................................#######............#
.............###########################....................................................................................#######............#
.............###########################..........######################....................................................#######............#
.............###########################..........######################....................................................#######............#
.............###########################..........######################....................................................#######............#
.............###########################..........######################....................................................#######......S.....#
.............###########################..........######################....................................................#######............#
.............###########################..........######################...................................................#######.............#
.............###########################..........######################.............................................########################..#
.............###########################..........######################.......................................................................#
.............###########################..........######################.......................................................................#
.............###########################..........######################.......................................................................#
.............###########################..........######################............############################################################
.............###########################..........######################............########## #################################################
.............###########################..........######################............########## #################################################
.............###########################..........######################............########## #################################################
.............###########################............................................########## #################################################
.............###########################............................................########## #################################################
.............###########################............................................############################################################
.............###########################.......................................................................................................#
...............................................................................................................................................#
...............................................................................................................................................#
...............................................................................................................................................#
...................###########.................................................................................................................#
...................###########.................................................................................................................#
...................###########.................................................................................................................#
...................###########................................................................ ##############################################..#
...................###########...............#########################........................ ##############################################..#
...................###########......##...............................#........................ ##############################################..#
...................###########......##...............................#........................ ##############################################..#
...................###########......##...............................#........................ ##############################################..#
...................###########......##...............................#........................ ###...................................########..#
...................###########......##.....#####################.....#........................ ###...................................########..#
...................###########......##.....#...................#.....#........................ ###...................................########..#
...................###########......##.....#...##.######.......#.....#........................ ###....................#..............########..#
...................###########......##.....#...#.......#.......#.....#........................ ###....................#..............########..#
...................###########......##.....#...#.......#.......#.....#........................ ###....................#..............########..#
...................###########......##.....#...#.......#.......#.....#........................ ###....................#..............########..#
...................###########......##.....#...#.......#.......#.....#........................ ###......###...####....#..............########..#
...................###########......##.....#...#.......#.......#.....#........................ ###......#........#....#..............########..#
...................###########......##.....#...#.......#.......#.....#........................ ###......#........#....#..............########..#
...................###########......##.....#...#.......#.......#.....#........................ ###......#........#....#..............########..#
...................###########......##.....#...#.......#.......#.....#........................ ###......#.......G#....#..............########..#
...................###########......##.....#...#.......#.......#.....#........................ ###......#........#....#..............########..#
...................###########......##.....#...#.......#.......#.....#........................ ###......##########....#..............########..#
...................###########......##.....#...##########......#.....#........................ ###................... #........................#
...................###########......##.....#...................#.....#........................ ###....................#........................#
...................###########......##.....#..##################.....#........................ ###.......##############........................#
...................###########......##...............................#........................ ###....................#........................#
...................###########......##...............................#........................ ###....................#........................#
...................###########......##################################........................ ###.............................................#
...................###########................................................................ ###.............................................#
...................###########................................................................ ###............................................,#
...................###########................................................................ ##############################################..#
...................###########................................................................ ##############################################..#
...................###########................................................................ ##############################################..#
.............................................................................................. ##############################################..#
.............................................................................................. ##############################################..#
.........................................................................................................................#.....................#
.........................................................................................................................#.....................#
.........................................................................................................................#.....................#
.........................................................................................................................#.....................#
.........................................................................................................................#.....................#
